NO ./textures/north.xpm
SO ./textures/south.xpm
WE ./textures/west.xpm
EA ./textures/east.xpm

F 220,100,0
C 225,30,0

1111111111111111111111111
1000000000110000000000001
1000000000000000000100001
10000W0000000000000000001
1111111111111111111111111

