NO ./textures/north.xpm
SO ./textures/south.xpm
WE ./textures/west.xpm
EA ./textures/east.xpm

F 0,204,0
C 0,102,204

1111111111111111111111111
1000000000110000000000001
1000000000000000000100001
1E00000000000000000000001
1111111111111111111111111
